map
xxxxxxxx
xxx...xx
x&t*..xx
xxx.*&xx
x&xx*.xx
x.x.&.xx
x*..**&x
x...&..x
xxxxxxxx
